CREATED BY = CRIADO POR
Hatsune Miku: Project DIVA Mega Mix+ STAFF = EQUIPE DE Hatsune Miku: Project DIVA Mega Mix+ 
Presented by = Apresentado por
In cooperation with = Em coopera√ß√£o com

PRODUCER/DIRECTOR = PRODUTOR/DIRETOR
GAME DESIGNER = DESIGNER DE JOGO
LEAD DESIGNER = DESIGNER CHEFE
LEAD 2D DESIGNER = DESIGNER 2D CHEFE
SPECIAL THANKS = AGRADECIMENTOS ESPECIAIS
CREATIVE PRODUCER = PRODUTOR CRIATIVO
DIRECTOR = DIRETOR
LEAD PROGRAMMER = PROGRAMADOR CHEFE
GAME DESIGNERS = DESIGNERS DE JOGO
PROGRAMMERS = PROGRAMADORES
STAGE DESIGNERS = DESIGNERS DE CEN√ÅRIOS
2D DESIGNER = DESIGNER 2D

Hatsune Miku: Project DIVA Arcade Future Tone STAFF = EQUIPE DE Hatsune Miku: Project DIVA Arcade Future Tone
LEAD PROGRAMMERS = PROGRAMADORES CHEFES
VIDEO ENGINEERS = T√âCNICOS DE V√çDEO
SOUND = SOM
LEAD DESIGNERS = DESIGNERS CHEFES
CHARACTER MODELS = MODELOS DE PERSONAGENS
2D DESIGNERS = DESIGNERS 2D
VIDEO ANIMATION ARTISTS = ARTISTAS DE ANIMA√á√ÉO DE V√çDEO
PRODUCT SUPPORT = SUPORTE DE PRODUTO

LOCALIZATION PRODUCER = PRODUTOR DE LOCALIZA√á√ÉO
TRANSLATION = TRADU√á√ÉO
EDITING = EDI√á√ÉO
LOCALIZATION COORDINATION & TOOLS = COORDENA√á√ÉO & FERRAMENTAS DE LOCALIZA√á√ÉO
QA LEADS = CHEFES DE GARANTIA DE QUALIDADE
QA COMPLIANCE = COMPLIANCE DE GARANTIA DE QUALIDADE
QA TESTING = TESTES DE GARANTIA DE QUALIDADE
PC DEVELOPMENT SERVICES = SERVI√áOS DE DESENVOLVIMENTO PARA COMPUTADORES
PRODUCTION SUPPORT = SUPORTE DE PRODU√á√ÉO
QA MANAGEMENT = GERENCIAMENTO DE GARANTIA DE QUALIDADE
PRODUCTION MANAGEMENT = GERENCIAMENTO DE PRODU√á√ÉO
BRAND MANAGEMENT & COMMS = GERENCIAMENTO DE MARCA & COMUNICA√á√ÉO
CREATIVE SERVICES = SERVI√áOS CRIATIVOS
1ST PARTY & EVENTS = DADOS PRIM√ÅRIOS & EVENTOS
MARKETING SERVICES = SERVI√áOS DE MARKETING
NA SALES & OPERATIONS = VENDAS & OPERA√á√ïES NA AM√âRICA DO NORTE
EMEA SALES, MARKETING, & OPERATIONS = VENDAS, MARKETING, & OPERA√á√ïES NA EMEA
CORPORATE STRATEGY = ESTRAT√âGIA CORPORATIVA
IT = TI
ACCOUNTING = CONTABILIDADE
FINANCE = FINAN√áAS
HR = RH
LEGAL = JUR√çDICO
CFO & SVP OF PRODUCTION = DIRETOR FINANCEIRO & VICE-PRESIDENTE S√äNIOR DA PRODU√á√ÉO
EVP OF PUBLISHING & STRATEGY = PROPOSTA DE VALOR PARA O EMPREGADO DE PUBLICA√á√ÉO & ESTRAT√âGIA
PRESIDENT & COO = PRESIDENTE & DIRETOR DE OPERA√á√ïES

MARKETING = MARKETING
PROMOTION = DIVULGA√á√ÉO
PRüûÑPUBLICTY = RELA√á√ïES P√öBLICASüûÑPUBLICIDADE
SALES PROMOTION = DIVULGA√á√ÉO DE VENDAS
WEB = WEB
GLOBAL MARKETING SUPPORT = SUPORTE DE MARKETING GLOBAL
PUBLIC RELATIONS = RELA√á√ïES P√öBLICAS
SALES = VENDAS
SALES PLANNING = PLANEJAMENTO DE VENDAS
PRODUCT SALES = VENDAS DE PRODUTO
SALES ADMINISTRATION = ADMINISTRA√á√ÉO DE VENDAS
LICENSING = LICENCIAMENTO
PACKAGE & MANUAL = PACOTE & MANUAL
PROJECT ADMINISTRATION DEPARTMENT = DEPARTAMENTO DE ADMINISTRA√á√ÉO DE PROJETO
SOFTWARE QUALITY CONTROL TEAM = TIME DE CONTROLE DE QUALIDADE DE SOFTWARE
PRODUCT CONTROL TEAM = TIME DE CONTROLE DE PRODUTO 
LOCALIZATION = LOCALIZA√á√ÉO
PRODUCT TEAM = TIME DE PRODUTO
EXPRESSION ETHICS = √âTICA DE EXPRESS√ÉO
QA TEAM = TIME DE GARANTIA DE QUALIDADE
SPECIAL THANKS (SEGA) = AGRADECIMENTOS ESPECIAIS (SEGA)
SUPERVISOR = SUPERVISOR
ASIA SALES DEPT. = DEPARTAMENTO DE VENDAS NA √ÅSIA

SUPERVISED BY = SUPERVISIONADO POR
CHARACTER VOICES = VOZES DE PERSONAGENS

CHOREOGRAPHERS/MOTION CAPTURE ACTOR COORDINATORS = COORDENADORES DE CORE√ìGRAFOS/ATORES DE CAPTURA DE MOVIMENTO
CHOREOGRAPHERS/MOTION CAPTURE ACTORS = CORE√ìGRAFOS/ATORES DE CAPTURA DE MOVIMENTO
SPECIAL SUPPORT = SUPORTE ESPECIAL
OPENING CINEMATIC PRODUCTION/COOPERATION = PRODU√á√ÉO/COOPERA√á√ÉO DA ANIMA√á√ÉO DE ABERTURA
PRODUCER = PRODUTOR
PROJECT MANAGER = GERENTE DE PROJETO
PROJECT SUPPORT = SUPORTE DE PROJETO
PRODUCTION/STORY BOARD = PRODU√á√ÉO/STORYBOARD
ADVISERS = CONSELHEIROS 
CG DESIGNER = DESIGNER GR√ÅFICO
TRANSLATION/PROOFREADING = TRADU√á√ÉO/REVIS√ÉO
Translation Team Manager = Gerente de Time de Tradu√ß√£o
Lead Translator = Tradutor Chefe
Translator = Tradutor
LQA Leader = Chefe de Garantia de Qualidade Lingu√≠stica
LQA Tester = Testador de Garantia de Qualidade Lingu√≠stica
LQA Support = Suporte de Garantia de Qualidade Lingu√≠stica
Project Coordinator = Coordenador de Projeto
Japanese Support = Suporte Japon√™s
Translators = Tradutores
Leader = Chefe
Producer = Produtor
International Project Manager = Gerente de Projeto Internacional
Project Managers (Italian) = Gerentes de Projeto (Italiano)
Project Manager (Spanish) = Gerente de Projeto (Espanhol)
Project Managers (French) = Gerentes de Projeto (Franc√™s)
Project Managers (German) = Gerentes de Projeto (Alem√£o)
Localization Engineers = T√©cnicos de Localiza√ß√£o
Localization QA Manager = Gerente de Garantia de Qualidade de Localiza√ß√£o
Localization QA Project Manager = Gerente de Projeto de Garantia de Qualidade de Localiza√ß√£o
Localization QA Senior Test Lead = Chefe de Teste S√™nior de Garantia de Qualidade de Localiza√ß√£o
QA Tester (French) = Testador de Garantia de Qualidade (Franc√™s)
QA Tester (Italian) = Testador de Garantia de Qualidade (Italiano)
QA Tester (German) = Testador de Garantia de Qualidade (Alem√£o)
QA Tester (Spanish) = Testador de Garantia de Qualidade (Espanhol)

T-SHIRT DESING COORDINATORS = COORDENADORES DE DESIGN DE CAMISA

CHIEF PRODUCER = PRODUTOR L√çDER
EXECUTIVE PRODUCERS = PRODUTORES EXECUTIVOS